9 10 
*********.
..*.......
......*...
....*.....
.*......*.
..........
.....*....
..*.......
......*...
